



 ------------
 |..........+
 |..........|
 |@f........|
 |..........|
 |..........|
 |..........+
 ------------







